00000000000000000000000000000000
00000000000000000000000000000000
00000000000000000000000000000004
00000000000000000000000000000005
00000000000000000000000000000005
00000000000000000000000000000005
00000000000001222230000000000005
00000000000000000000000000000005
00000000000000000000000000000005
23000000000000000000000000000005
55223000000000000000000012222225
55555222300000004000000000000005
00000000000000005300000000000005
00000000000000005530000000000000
00000000000000005550000000000000
00000000004000005550000000000000
00000000015000005550000000000000
12222222255200005122222222222223

00000000000000000000000000000000
00000000000000000000000000000000
00000000000000000000000000000003
00000000000000000000000000000002
00000000000000000000000000000002
00000000000000000000000000000002
00000000000001111110000000000002
00000000000000000000000000000002
00000000000000000000000000000002
00000000000000000000000000000002
00000000000000000000111111111112
00000000000000000000000000000002
00000000000000000000000012230002
00000000000000000000000000000000
00000000000000000000000000000000
00000000003000000000000000000000
00000000000000000000000000000000
11111111111200001111111111111111